11111111111111
100B00B00B00B1
100C00C00C00C1
100P00B00B00E1
100C00C00C00C1
1BB0BB0BB0BB01
11111111111111