111111111
100000001
10000E001
11111B111
11111C111
10000P001
111111111