1111111111111111111111
1000000000000000000001
100000111100000000E001
1000000000111110000001
100000000000000111C111
1000000000000000000001
1BBPCCB111111111111111
1111111111111111111111