111111111111111111111111111111
111110000000011111111000000001
11110111110000000E111110000001
1C000C000C00000000011111000001
111111111110011110011110000001
100000000000011110011100000001
100000001111110110000000000001
100000001111111110011110000001
1P0000000000000000000C1100C001
111111111111111111111111111111