1111111
111P111
1000001
1000001
1001001
1001001
1001001
10C1001
111E001
1110011
1001011
1001001
100C001
1111111