11111111111
100P0011111
10000011111
1C000C11111
10000011111
111E1111111
11111111111