111110111111111
1000000E0000001
00000000P000001
10000000C000001
10000000C000000
111111111011111