111111111111111111111111111
10000000000CC11110000000101
1000100001000P00000111001P1
1000E1110001010000011010E01
100000000000000000000000001
111111111111111111111111111
111111111111111111111111111