1111111111111111111
1001N0C1100000000C1
100D110011101100001
1000000000000101011
1PN00EC000001100111
1010111001100000001
10100100C0011000101
10100100011111101C1
1C0C0N00000000000N1
1111111111111111111