11111111111111
10000000000001
10000P11111111		
10000C11111111
1000E111111111
111111111
10000000011111
11111111111111