1111111111
1EB0000001
11000B0001
10000000C1
11111P1111
1111111111