11111111111111111111111111111
1CC100001000000C0011000000001
11110000C00001101011000000001
10000000100001101011000000001
10000000E000011010110000C0001
1P000111000000000001000000001
11111111111111000001000000001
11111111111111111111111111111